10,11
##########
#..#.....#
#..#.....#
#.##.....#
#.....####
#.....#..#
#..#.....#
#.....####
#........#
#........#
##########