10,11
@@@@@@@@@@
@..#.....@
@..#.....@
@.##.....@
@.....###@
@.....#..@
@..#.....@
@.....###@
@........@
@........@
@@@@@@@@@@